5 8
########
#......#
#.#S#.##
##...###
########
