########
#LLURRR#
#D#S#D##
##LDR###
########
